Acht Berge

SEITE001
Seit jeher: ever since
Leb wohl: good bye
hegt (hegen): foster

SEITE009
auf seine Art: his way, AKK
Dickkopf: stubborn
Draufgänger: daredevil
einzuteilen: distribute
rasten: rest
Kälte: cold
johlend: shout
hinab: down
zog sie es vor (vorziehen): prefer
veranstalten: organize
Kuppen= summits
erwähnen=mention
ragten (ragen) = tower
Gewändern=garments
verfrachteten=ship
Gelassenheit=serenity
Tugenden=virtues
Ausdauer=endurance
angeblich=alledgedly
brodelte=simmer
anschwoll=swell
säumte=lined up
hielt an (aushalten)=withstand
beschimpfen=vituperate
schlüupfen=slip
Dauerregen=continuous rains
schlimmig=moldy
Holzbalken=timber
Beratungstelle=helpdesk
Sendungsbewusstsein=sense of mission
Ulmen=elms
Hohn=mockery
durchzuringen=bring oneself
hingegen=however
fortwährend=continuously
Entlassung=layoff
gebeutelt=malconcio
vorfiel=occur
wutentbrannt=furious
Besteck=cutlery
erstarrt=frozen

SEITE013

fluchten (fluchen)=curse,swear
ausartete=degenerate
Schützengraben=trenches
erzwingen=force
trat (treten)=step
besänftigen=appease
Widerhall=echo
Überbleibsel=leftover
Flurtischchen=tavolo da ingresso
Tenne=barn floor,aia

SEITE014
verflog (verfliehen)=evaporate
Wehmut=melancholy
woraufhin=whereupon
harrte=await
irgendwann=sometime
Rührung=emotion
Überführung=crossover
Verehrer=devotee
Windschutzscheibe=windshield
nachhingen=daydream
hupte (hupen)=hoot
verwünschte=imprecate
den Gang einlegte=put in the gear
davonfuhr (fahren)=drove away
schnürtnen=lace up
schrofferen=rugged
beklemmenden=oppressive

SEITE016
Wildbäche=torrents
schnurrstracks=straight away
woandershin=somewhere else
unsteten=unsteady
zog er sich um (umziehen)=he changed clothes
Karohemd=checked shirt
Cordhose=pantaloni di velluto a coste
Wandern=hikes
in diesen Dörfern (Dorf)=villages
vorzulesen=read aloud
wiederholt=repeatedly
Höchstsumme=max amount
nippte (nippen)=sip
Schoss=womb
Bereitwillig=readily

SEITE018
Almhutten (Alm=Alp)=chalets
Geröllfeldern=debris
geschwungenen=curved
Höhenangabe=Height indication
dermassen=so
aufbrechen=set out
weitaus=far

SEITE021
Ausläufer=diramazione
abgetan=dismissed
Schotterweg=gravel road
floss (fliessen)=flow
auffunkeln=sparkle
fällen=abbattere
Floss=raft
hingab=indulge

SEITE022
aufgebrochen (aufbrechen)=start
musterte=examined
Scheunen=barns
weideten (waiden)=graze
ausluden=unload
beschnuppern=sniff
kraulte=scratched,fondle
Dachgepäckträger=roof rack
verheissungsvoll=promising
Schuppen=hangar
Stützpfähle=support piles
türmten=piled up
obenauf=on top
Anstalten=preparations
insgeheim=secretly
Blösse zu geben=to lower one's guard
Begabung=talent
hochhob=lift
Tränke=drinking trough
umschliessen=surround
bemoosten=mossy
Steinschindeln=tegole di tetto
russgeschwärzte=blackened with soot
Schornstein=chimney

SEITE024
Hängeschränke=wall cupboard
Küchenspüle=kitchen sink
ausnahmslos=invariably
angeschimmelt=moldy
ausgeblichen=faded
gusseiserner=cast iron
einrichten=furnish
wortkarg=taciturn
entgegennahm=accepted
belauern=stalk
Einbruch=break-in
abgereist=leave
schichtete=layer
Holzscheite=wood billet
knüllte=crumple
hüllen=wrapped
anbrannte=burn
wusch (waschen)=wash
Erkundungsgebiet=exploration area
Klamm=ravine
Stromschnellen=rapids
ungestüm=impetuous
Birken=betulle
Dickicht=boshetto
Schotterrinne=gravel channel
Baumstämme=tree trunks

SEITE026
faulten=rot
eintrübte=offuscati
hin und her wogten=back and forth waved
gebogenen Knauf=bent handle
gescheckt=spotted
auf eigene Faust=on their own
hinterherrannte=run after
widerstrebend=reluctantly
Wiese=meadow
watete (waten)=wade
durchweichter=sodden
klatschnassen=wet all over
würdigen=degnare
vollgesogen=soaked
aufleben=revive
anstellen=start,engage
weit vorhaus=way ahead
Nutzgarten=Kitchen garden
Sägewerk=sawmill
Molkerei=dairy
Milchkannen=milk cans
vorbeizubringen=bring over
Balkongeländer=Balcony railing


SEITE028
roch (riechen)=smell
Duft=smell
geronnener=coagulated
verschlang (verschlingen)=devour
hinterher=after
Stegs=bridge
flüsternd=whispering
unauffällig=unremarkable
hinausspähen=peek out
aus den Augen lassen=lose sight of
flachsblondes Haar=flax blonde hair
hochgekrempelten=rolled up
Nicken=nod
tosenden=roaring
abgesetzt=deposited
Gräser=grass
modrige=rotting
entzückte=delighted
gespäht=peeked

SEITE030
Maul=nozzle
entgegenstellen=oppose
fuchtelte=waved
auseinanderstoben=scapparono da una parte all'altra
Kiesel=pebble
Uferböschung=argine
Wärterhäuschen=attendant's hut
Brennnesseln=ortiche
Sätzen=frasi
schrammte=raschiarsi
Falltür=trapdoor
herabliess=descend
Moder=rot
morschem=rotten
übersät=littered
Mahlstein=millstone
glitschig=slippery
Moss=muschio

SEITE032
vorhin=earlier
aufgeschürft=raschiato
hochkant=upright
runterkullern=roll down
auf Anhieb=at first
losrollte=roll off
Einwände erheben=raise objections
Fällkeile=hedges
anheben=raise
feststeckte=stuck
schob=push
Steinbrocken=stone chipping
ächzte=groan
wedelte=wag
lutschte=suck
vor lauter Aufregung=for pure excitement
gespürt=felt
unverhoffte=unexpected
reglos=motionless
treiben=float
dämmerte=dawned
überholt=superato

SEITE034
zogen=push
lauschte=listened
streunt=roam
Summen=buzz
Laterne=lamp
Prasseln=crackling
angelockt=lure
Brei=mash
hingegen=on the contrary
Bienenstöcke=beehives
Hacke und Rechen=pick and rake
verkündete=announced
Obhut=custody
schaltete ein=coinvolgersi
zuckte=contrasse
durchringen=bring himself
bejahen=affirm
vorerst=for now

SEITE036
drang (dringen)=insist
Heuschober=haystack
Kornspeicher=granary
Eckbank=corner seat
Anrichte=credenza
Gestrüpp=macchia
aufgestossen=opened up
gezüchtet (züchten)=allevati
gereihten=allineati
beäugten=eyed,ogled
vergorenen=fermented
Lehrerpult=desk
gestapelten=stacked
hineingeritzt=carved into it
nachzuhaken=pursue,follow up
schnaubte=snorted
Schwebe=suspence
erraten=guess
eingeritzt=scratched
Einkerbungen=notches
begriff (begreifen)=understand

SEITE038
erahnen=guess
gemähte=mowed
Handbreit=hand
Saumpfad=mulattiera
Hufgetrappel=hooves pounding
Talsohle=valley floor
reger Verkehr=lively traffic
Dörfler=villagers
heiter=bright
träge=sluggish
gesättigte=saturated
Hörer=earpiece
Gebirgler=montanaro
Auflegen=hang up
insgeheim=secretly
aufgerissen=torn open
gelassen=calmly
flackernden=flickering

SEITE040
klapprigen=shaky
vergeuden=waste
Reisszwecken=Thumbtacks
einzeichnen=plot
zuteilwurde=was granted
fuhren (fahren)=travelled
angesagter=more hip
taunass=dew wet
schnallte  (schnallen)=fasten
einschlug=drive in
beschienenen=illuminated
bescherte=bestowed
Rast=rest
Weggabelung=bivio
japste (japsen)=gasp
duldete (dulden)=tolerate
verschnaufen=to catch one's breath 
keinerlei=not at all
beibrachte=teach
Austausch=exchange
Anstrengung=effort
geschliffen=polished

SEITE042
verliehen=award,give
hinaustraten (hinaus=out, treten=step)=stepped out
stiessen (stossen)=bumped
lauter=nothing but
vereinzelten=isolated
Gelände=terrain
eingeebnet (einebnen, ebnen=eben machen) =leveled
aufgeschichtet=piled up
ausgehoben=excavated
anzulegen=edify
einstigen=former
betreiben=operate
vorwagte=ventured
Entbehrungen=austerity
baufälligen=dilapidated
Rätseln=puzzles
Vorgesetzte=superiors
kommt ganz darauf an=it depends
holen wir die ein=let's catch up with them
strotzten=be bursting
Knöcheln=ankles

SEITE044
Auffassung=opinion
sie wichen (weichen) seitlich aus=they give way laterally
Floskeln=empty phrases
vorgesehen=intended
Heidelbeeren=blueberries
Wacholder=juniper
anschliessenden=subsequent
wichen (weichen)=give way
Mulden=trough
schlugen=beat
Blitzeinschlägen=lightning strikes

SEITE046
ablegte=dropped
Seilschaften=cordate
bescheidene=modest,humble
erhabenen=sublime
gewundene=tortuous
zerklüftete=fissured
nachvollziehen=comprehend
vorhalten=hold out
Sauseschritt=a passo di carica
Kriegsgeheul=Howl of war
gejohle=howling
Acker=fields
verlässlich=reliable
Käppi=cap
gebückt=bent over


SEITE048
seltsam=strange
aufgelegt=disposed
partout=at all costs
Kühehüten=cow guards
anders gelagert ist=is different
konterte=countered,replied
Mulde=trough
Rinnsalen=rivoulets,trickle
Farnen=ferns
matschig=muddy
Miene=face,expression
Gram=grief
struppigen=shaggy

SEITE050
zugesägten=sawn
Dachbalken=roof beans
Schäbigkeit=shabbiness
Wellblech=Corrugated iron
hausten=dwelled
reiften=matured
Käselaibe=cheeses
abgenagter=gnawed
Liebesmüh=waste of effort
Auflagen=conditions
Liebhaberei=hobby

SEITE052
verstreuten=scattered
Sträuchern=bushes
getilgt=erase
hinzulegen=to lay down
zu einem Grinsen verzogenen Mund=mouth twisted into a grin
zerklüftete Kämme=jagged ridges
gemeint=meant
allmählich=gradually
ich hab vor, ihn morgen zu begehen=I plan to do it tomorrow 
stapfen=trudge

SEITE054
sich verstellen=dissimulate
unaufhaltsam=inexorable
mattglänzenden=matt-finished
mitnichten=by no means 
staunte (stauen)=marvel
Hangneigung=gradient
ungewohnt=unusual
Abgase=exhaust

SEITE056
herumliefen (laufen)=walked around
proppenvoll=jam-packed
kratzigen=itchy
abglichen=matched
gesellt=joined
schüchtern=shy
entging (entgehen)=escape
Kegel=cone
Schnapsfahne=???
ich stellte mich schlafend=I pretended to be asleep
perlmuttfarben=mother-of-pearl
losgezogen (losziehen)=set off
herumrascheln=rustling around
Schiffbrüchige=Shipwrecked

SEITE058
wickelte=wrapped
Schlaufe=loop
aufwändige=elaborate
umständliche=awkward
Stahlzacken=Steel prongs
einigermassen=to some extent
verflüchtigte=evaporated
verschnaufen=to catch one's breath (BIS)
blähten (blähen)=swell
eingestand (eingestehen)=admit
beharrte=persisted
nachholen=catch up
vorbeugte=bent over
Gefälle=slope
Gebilde=structures
geborstenen (bersten)=broken
auftürmenden=towering
aufgebrochen=set out
überwinden=overcome

SEITE060
Brechreiz=nausea
Galle=bile
schlapp=flappy


SEITE062
Schneeraupen=battipista
plattgewalzten=flattened,steamrolled
schlepplift=skilift
Heerscharen=legions
Sessellift=chairlift
gefälligst=kindly
Unbeschwertheit=carefree
Schwermut=melancholy
Niedergeschlagenheit=depression,dejection
in Verzückung geraten=in ecstasy
berauschte mich=inebriate
ausmalen=imagine
über jäh=bruscamente
aufgegebenen=abbandonato
ansatzweise=in una certa misura
hindurchschlängeln=thread my way through
eingebildet (einbilden)=imagined
Trieb=drive

SEITE064
herbeisehnen=long for
heranwachsen=grow up
hereinkommen=walk in
Treppenabsatz=platform
Geländer=railing
wir fest davon ausgingen=we firmly assumed
lotste (lotsen)=guide
Vorankündigung=prior notice
Schnürsenkel=shoelaces
band (binden)=tie
höhnisch=derisive
anschlug=aim at
anstellen=to get into mischief 
Erstürmen=take by storm
ausgetretenen=trodden
querfeldein=across
zügig=rapid
drauflos=straight on
aufzeigte=disclose
Kiefern=pine
windschief=crooked
überwucherten=overgrown
Kohlenmeiler=charcoal pile

SEITE066
entschlüsselte=decypher
beibringen=procure
treffend=appropriate
Lärche=larici
Rotbuche=faggio
Zirbelkiefer=pino cembro
an etwas (DAT) hängen=aggrapparsi a qualcosa
Stollen=tunnel
abgebaut=depleted
fortgeschafft=carried away
einstürzen=collapse
erhobenen Hauptes=col capo alto
Unannehmlichkeiten=trouble
Pfützen=puddle
kehrtzumachen=to turn around
rächten (rächen)=avenge
Tierbaue=dens, animal house
verbeulten Napf=dented bowl
auskunftsfreudig=informative

SEITE068
ausfocht=fought
Ziehsohn=foster son
Erdkunde=geografia
büffelte (büffeln)=schiaffeggiare
ordentlich=properly
angezogen=dressed
haderte (hadern)=quarrel
antaten (antun)=fare
eifrig=eager
klaglos=without complaint
bekochen=cook
knuddeln=cuddle
zuhörte=listen
ausholte=strike out
Einvernehmen=understanding
Scheu=shy
ertappte=caught

SEITE070
bestand (bestehen)=pass
anrief (anrufen)=call
Schachtel=box
Stechbeiteln=chisel
Schnitzeisen=carving iron
andersherum=the other way round
betraten (betreten)=entered
dahinfloss=floated away
Riesentümpel=Giant pool
zerrten (zerren)=dragged
einklemmten=trapped,clipped
entsprang=arose
Ländereien=real estate
Erlen=ontani
auf...tat (auftun)=aprirsi
Kieseln=pebbles
einsilbig=monosyllabic

SEITE072
Geröll=rubble
Rascheln=rustle
Hinhören=listen
Wünschelrutengänger=water diviner
würdig=worthy
ragte=loom
irgendwann=eventually
vorhatten=intended
Vortag=the day before
vorgeschlagen=proposed
aufnehmen=take up,include
schwebte (schweben)=impend

SEITE074
Schulabschluss=graduation
buddelte=digged
Schnaubend=snorting
handbreite=hand width
speisten=feed
sträuben=resist
wusch (waschen)=washed
kraxle=scramble

SEITE076
Trichter=funnel
Tagesanbruch=daybreak
Krächzen=caw,croak
Abfolge=sequence
die Seele aus dem Leib kotzen=puke the soul out of the body
vornehmen=carry out
geröteten=reddened
andächtige=pious
krakelige=spidery
raufziehen=???
Zuflucht=refuge

SEITE078
widerwärtig=disgusting
eingeschenkt=poured
prostete mir zu=toasted me
bezwinger=conqueror
aufgeknöpftem=to button down 
Gesimse=corniche
verschwommene=blurred
getrübte=clouded
Balkonbrüstung=balcony parapet
von ihrem Rand erheben musste=had to rise from its edge
entgegenzutreten=to oppose
anzulegen=to put on

SEITE080
Stirn=forehead
Wangenknochen=cheekbone
Kragen=collar
zischte=hissed
bleckte ein Gebiss=bared denture
behutsam=cautiously
entgegensetzen=contrast,oppose
Waden=calves
Strümpfe=stockings
langging=long walked (???)
ballte (ballen)=clenched
Hieb=cut
Schläfe=temple
Boxhaken=boxing hook
Knüppel=stick
taumelte=staggered,reeled
herabhängen=hang down
schlaff=flaccid
Rücken=back
einfordern=claim
er sich mit dem Falschen angelegt hatte=he had messed with the wrong guy
Aber darauf kam es nicht an=But that didn't matter
Einbruch=break-in
bedrückt=depressed
geknüpft=tied

SEITE082
verhüllte=veiled
herumstapfen=trudging around
Rechenschaft abzulegen=Accountability discard
verrammelten=barricaded
ebenfalls=also
zuschlagen=hit,slam
austeilen=distribute
eigentlich=actual
Anlass=occasion
nichtig=futile
erstanden=acquired
Förster=forest ranger
Ausflüchte=excuses
auffielen=stood out

SEITE084
besänftigend=soothing
Auseinandersetzung=altercation
Heringe=pegs
im Nu=in a flash
hielt inne=stopped for a moment
schaute auf=looked up
störrischer=mulish
Gurt=belt
Redeerlaubnis=Permission to speak
glättend=glazing
nachhaken=to dig deeper
beleidigt=offended
Befreiungsakt=act of liberation

SEITE086
umsehen=look around
bestaunte=wonder at
Tupfer=mop
knallige=gaudy
Nadelbäume=conifer
Eigenbrötlertum=solitude
Geländewagen=Off-road vehicle
wiegend=swaying
stemmen=lever,prop
lautstark=vociferous
hochkrempeln=tuck up
Gesässtasche=hip pocket
hervorschaute=peered
zerknitterten=crumpled
Schein=banknote
x-beliebig=any old
ausstehen=suffer
Tonfall=accent
vertrödelten=idle away
verbargen=hid


SEITE088
gesprossen (spriessen)=sprout
Überzug=coat
Eisenbürsten=iron brushes
wetteiferten (wetteifern)=compete
gelenkig=flexible
Turner=gymnast
Fachwissen=know how
scharten (scharen)=gather
Harzduft=piney fragrance
Begüterten=moneyed
hochgezogene=elevated
Kästen=coffer,chest
Anwesen=estate
Kunstbände=art books

SEITE090
Beleidigten=offended
verschaffen=procure
sich vorgenommen=to take something up
derjenige=the one who
auf ihn zugehen=to go to him
besessen (besitzen)=possess
an besagten Morgen=said morning
übervoll=overfull
nachzueifern=emulate

SEITE092
Anmut=grace
geriet (geraten)=fall,get
blindlings=blindly
schummelt=cheats
Ehrgeiz=ambition
Spalt=crack,fissure
Ösenschraube=eyebolt,eye screw

SEITE094
ich kam gut voran=I made good progress
aufschürfte (aufschürfen)=to graze oneself, scraped
Schritt=footstep
vergangen=departed
Schnur=line,string, spago
rücklings=backwards
umschlagen=change suddenly
aufgebrochen=started
zerrte (zerren)=drag,jerk

SEITE096
knisternde=crackling
streifte (streifen)=wander
Erhebungen=rising
umherstreifen=ramble
ausmachen=locate
Senke=dip
Flause=Unsinn,Spinnerei
Kennzeichen=license plate
Verlegenheit=embarassment
Anhöhe=elevation
ausmahlte (ausmalen)=paint in
bescherte (bescheren)=bestow

SEITE098
Glockengeläut=bell ringing
zu dritt oder viert =in 3 or 4
Mütter (plural of Mutter) und Zicklein=madri e bambini
gefügig=docile
anbrüllen=yell at
liefen (laufen)=run
besagter=aforesaid
hinpendeln,herpendeln=commute
nachhakte (nachhaken)=follow up

SEITE100
anbekam (ankommen)=attain
Versöhnung=conciliazioni

SEITE102
gezeugt (zeugen)=conceived
schuften=toil away
geerbt (erben)=inherit
auf Anhieb=instantly,at start

SEITE104
vorweisen=produce
grusslos=with no greetings
bemühte (sich bemühen)=try
wiederum=in turn
schildern=describe
gekonnt (können)=can
konnte (können)
Gestalt=shape
annahm (annehmen)=accept,assume
ergriff (ergreifen)=catch
anstrengen=strain,exert
kürzertreten=slow down,step down
Verrentung=retirement
Niederlassung=location
krankhaft=morbid
schrak hoch (hochschrecken)=startle
flehte sie an (anflehen)=implore

SEITE106
gehetzt (hetzen)=hounded,hurried
anstrengend=arduous
durchgetretenem=trodden
ausgeschiedener=retired
Anweisung=instructions
aufsetzen=lay
vermache=bequeath
kühl=cool
Auszug=walkout
ehrenamtlich=voluntarily
erworben=acquired

SEITE108
im Vorfeld=previously
Flurkarte=cadastral map
zwangsläufig=inevitably
Bedürfnis=need
baggern=excavate
Kies=gravel

SEITE110
hinterherhinken=to drag behind 
Ausschau=look out,prospect
Schläfe=temple
gestützt=supported
Lockruf=call
aufragten=loom
Fleckchen=beauty spot
Holzscheiten=wood billet
pustete (pusten)=blew
aufzüngelten=flickered
angesetzten=impostate
wohnlich einrichtet=homely set up
Gardinen=curtains
Aussicht=view
Krug=jug
verwegenem=daring

SEITE112
nachzuschenken=refill
Grübeln=ruminations
auf die Sprünge halfen=help on the jumps
verschlungenen=tangled
Holz nachlegen=to stoke a fire with wood 
Scheite=pezzo di legno
abholen=collect
in aller Herrgottsfrühe=at the crack of dawn
Beileidsformel=Condolence formula
schwielig (Schwiele)=callous

SEITE114
Glied=limb
Abzug=trigger
du ähnelst deinem Vater=you look like your father
kräuselte (kräuseln)=increspare
Scheune=barn (fienile)
Pflug=aratro
Bagger=excavator
mitbekommen=realize
ragen=protrude
hingekriegt=managed

SEITE116
wagenheber=jack (crick)
verkneifen=trattenere
Fahrt aufnahm=picked up speed
brachen wir auf (aufbrechen)=set out
Grundstück=property,piece of land
befolgen=follow
durchgebogenen=bent
täuschte (täuschen)=deceive
Angeln=hinges
angerichtet=wreak
abgetragen (abtragen)=strip,dig
nachgab (nachgeben)=to give in
Bruno schwieg nach wie vor=Bruno was still silent
die Beine vertreten=maintain
er war mir aufgefallen=I noticed him
Matsch=sludge

SEITE118
betupft=tamponato
hinfiel=cadde
unvermittelt=suddenly
Sprünge=cracks
Bruchkanten=breaklines
Eisschollen=ice sheets
sonnenbeschienenen=sunlit (beschienen=illuminate)
Schattierungen=shades
schweifen=wander
gönnte=allowed
abklopfte=beat off
Zirbelkiefer=pine


SEITE120
drei Jahre her=three years ago
ausfindig zu machen=to detect
Graupel=sleet
gehegt=foster
wandte ich ein=I objected

SEITE122
Handlanger=handy-man
ausgedacht=thought up
erläutern=explain
ergoss=poured out
Kraftstoff=fuel
derjenige=the one who
lauter unverzeihliche Fehler=lots of unforgivable mistakes
verharrten=pause
gewichen (weichen)=soak

SEITE124
bröckeln=crumble
begradigen=straighten
trug sie ab (abtragen)=to strip,to wear
zog sie hoch (hochziehen)=pull up
Bodendielen=floor boards
wühlte (wühlen)=rummaged
Stöckchen=stick

SEITE126
Futterkrippen=Feeding troughs
Jauche=manure,sewage
Sensenstein=Scythe stone
Sense wetzt (wetzen)=scythe (falce) sharpen
Flusskiesel=Ciottoli di fiume
Dielen=tavole del pavimento
abtragen=remove

SEITE128
todgeweiht (weihen, dedicato)=condannato,moribondo
vorm (vor dem)=prima
Holzpflöcken=Wooden pegs

SEITE130
belädt (laden)=load,burden
stapfte=trudge
Trostlosigkeit=desolation
Hinterlassenschaften=legacy,estate
streifte=graze
Ebenbild=image,counterpart

SEITE132
belud (beladen)=load
Brei=pulp
kuschelte=cuddle
Einvernehmen=agreement
gelingen=succeed

SEITE134
fürsorglich=caring
Heimlichtuerei=sneakiness
Inwiefern=how
zerstritten (zerstreiten)=quarrel
Stücke=piece

SEITE136
Zwillingsseilsträngen=Twin rope strands
verstaute=store
Wucht=force

SEITE138
einfräsen=mill in
Umfangs=size
lotrechte=perpendicular

SEITE140
künden=witness
vorbeugen=bend forward
streichen=paint,scratch
erloschen=extinguished
allmorgendlicht=every morning
Harz=resin
Meissel=chisel
entfachte=spark
Glut=embers
rausriss=ripped out

SEITE142
zugehalten=hold closed
ablehnend=hostile
Marotten=stranezze, quirks
zusammensetzen=put together
Rotwild=red deer
verharrte=remain
durchzuschlagen=knock through

SEITE144
Fantasiebegabtere=more imaginative
austoben=let off steam
verausgaben=spend
Ausgewanderten=emigrants
durchaus=absolutely
hineinversetzen=to put inside
entgegensetzen=oppose
Einfühlungsvermögen=empathy
gegenübergetreten=confront,oppose
fuhren (fahren)=viaggiare
per Anhalter fahren=hitchhike

SEITE146
Mörser=mortar
einläutete=herald
zurückzulegen=lay back
Langkofel scharte=Langkofel valley
ansteuerten=drive
prallen=blazing
auftürmt=pile
auslaufen=run out

SEITE148
gefaucht=growl
Störenfried=mischief
auf die leichte schulter nehmen=take something lightly
verrauchte=smoked
einnistete=nested
finster=dark
behelligte=bother
mit zunehmendem Alter=with increasing age
ungerecht=unjust
ausgeschlagen=rejected
Bleibe=abode
Bestandteil=part,component
schlechthin=per se, absolutely
althergebrachten=traditional

SEITE150
vermacht=bequeathed
Schindeln=assicelle
Schuppen=shed
Furchen=furrow,solchi
Oberlicht=lucernaio
deshalb=therefore
blendeten=dazzle

SEITE152
Walzblei=Piombo arrotolato
Erlenwald=foresta di ontani
Schneise=corsia
drängten sich=affollavano
karge=barren
Nachgiebiges=yielding,soft

SEITE154
körnig=granular
Kamm=comb,ridge
Blöken=bleat

SEITE156
Ich stiess auf=I came across
belanglos=irrelevant
Ausrufezeichen=exclamation mark
losgerannt (losrennen)=ran off
verstaute (verstauen)=store
vernachlässigten=neglected
Mittellagen=middle layers
Eigenbrötler=loner
einholte=caught up

SEITE158
stopfte=stuffed
prahlerisch=boastful
abgehakt=checked off
unbehelligt=unmolested
hinausstürzten=rushed out
Angelrute=fishing rod
samt=together

SEITE160
gehauenen=carved
heilfroh=really glad

SEITE162
unausweichlich=inevitable
wuchern=grow
bückte (bücken)=bend down
jäten=weed
liebend gern=with love
verkam (verkommen)=degenerate
dicht=tight,dense
hinbekommen=get it

SEITE164
durchaus=absolutely
anmassend=arrogant
ich es leid war=I was tired of it
abgeschuftet (abschuffen)=drudge
um die Runden zu kommen=arrivare a fine mese
Flieger=plane
spaßeshalber=just for fun
Sitztruhe=cassapanca
Anrichte=credenza
Schleifpapier=carta vetrata
aufgearbeitet=lavorato
Bohlen=tavole
Vorratsraum=dispensa
verstauten=stowed
Riegel=bar,latch

SEITE166
straucheln=stumble
verdorrte=wither
Zügel=reins
voranzugehen=to go ahead

SEITE170
verarbeitet=processed
krakeelten=brawl
Gaumen=palate
verwöhnen=spoil
verschnaufte=to catch one's breath
zustande brachte=achieve

SEITE172
ausgegangen=start
aus der Übung=out of practice
verwischte=efface
schlichte=simple
Einsiedler kate=hermit ???
wohligen=cozy
aufgestaut=dammed up

SEITE174
einschlagen=hit,pursue
erproben=test,try out
von Dauer gewesen=been permanent
umsetzen=implement
sich rarmachen=farsi vedere poco in giro
bewährte=to prove of value

SEITE176
nichts einzuwenden haben=to have no objections 
der Entschluss=decision
abgewiesen=rejected
Verzug=delay
schlug er sich mit jemandem herum=he was fighting someone
Fliesen=tiles
zur Genüge kannte=knew enough
schielte=squint
schielte zu ihr hinüber=looked over at her
Stichelei=teasing
es war das Mindeste, was ihr zustand=it was the least she was entitled to
zur Genüge=enough

SEITE178
zäh=tough
euch gestritten=quarreled
raufzieht=pull up
vorhatte (vorhaben)=plan
eingeholt=caught up
Auflegen=hang up
knieten=kneeled
pflückten=pick,cull
Ähren=spighe
droschen (dreschen)=thresh, battere
pflügten (pflügen)=arare
klapperdürres=scraggy 
Ochsengespann=team of oxen
Weidenkörbe=wicker basket

SEITE180
spitz und scharfkantig=pointed and sharp-edged
Tröge=truogoli
schuppiger=flaky
wogender=ansante
Lehm=clay
verputzt=plastered
zarte=tender
Knospe=bud
rieten (raten)=advise

SEITE182
weshalb=for which reason
scharren=scratch
grasten=graze
Pavian=baboon
betrat=entered
anfreudeten=were pleased
Fahnen=flags
abgeschüttelt=shaken off
vergötterte=idolized
liebkosten=caress
unablässig=incessantly
rückversichern=reinsure
allesamt trächtig=all pregnant
geflohen=fled
umstellt=surrounded
vorneweg=ahead
Schlusslicht=taillight
holten (holen)=fetch

SEITE184
Bimmeln=jingle
übertönten (übertönen)=drown
Wiederbelebungsmassnahme=Resuscitation measure
bergan=uphill
gesellte=joined
ausgerechnet=just
anschneiden=touch on,cut
Löwenzahn=dandelion
knallgelbe=bright yellow
gejätet (jäten)=weeded
humpelnd=limping
nachzog (nachziehen)=follow
zügig=rapid
dürr=dry
schier=almost
prosteten (prosten)=cheer,toast
einlebten=settle in

SEITE186
ergab (ergeben)=produce, yield
ausschlafen=sleep in
überlassen=leave 
liebkosen=caress
Gezwitscher=twittering
Vorabend=eve
abzuschöpfen (abschöpfen)=skim
Lab=rennet,caglio
Tüchern=cloth,fabric
abgeseiht=sieved,strain
gemächlich=leisurely
Reh=deer

SEITE188
umherstreifte=prowled
Witterung=scent
Läuten=chime
gibt aus (aufgeben)=to give up
aufheben=cancel,set aside
Anspielung=reference,allusion

SEITE190
verlernen=unlearn
gurgelte=gurgled
Senke=trough
blies (blasen)=blew
Stute=female horse
Nicken=nod

SEITE192
Schlusslicht=tail lamp,rear end light
abschüssig=steep,precipitous 
davonbrausen=dash off, speed off, go with full speed
kulisse=backdrop scenery
abzuhauen=to run away
Dampflok=steam locomotive
ausgesucht=select

SEITE194
bedrückte=depressed
löste auf (auflösen)=terminate,cancel
rausträgt=carry out
Verlobungsring=Engagement ring
büssen=atone,expiate

SEITE196
zugehörig=belonging to
hinauffuhr (hinauffahren)=drove up
gescharrt (scharren)=scratched
schlüpften (schlüpfen)=hatched
Vorhaben=project,plan

SEITE198
förmlich=formally,frigid
Gehege=enclosure
Adler=eagle
es rechnet sich=it pays off
absichtlich=intentionally
lostrat (lostreten)=kick off
verfehlt (verfehlen)=miss,fail

SEITE200
Steinhagel=hail of stones
bezeugten (bezeugen)=testify
Furchen=solchi

SEITE202
leibhaftig=incarnato
ausholenden=sweeping
verdingten (verdingen)=to hire oneself out
Geltungssucht=ossessione
Machtstreben=Striving for power

SEITE204
sie hatte seine Knöckel  verstaut=si era slogata la caviglia
Sonnenstich=sunstroke
sich schonen=take things easy
ohne sie gross anstellen=without making them big
regelrecht=regularly
kam zum Erliegen=came to a standstill
Vordächer=porches
einwandfrei=unobjectionable
danach=after that
nach wie vor=still
gebürstetem Fell=brushed fur
Umzug=move,procession
Fichtenwipfel=spruce treetops
Brachen=wasteland

SEITE206
der Flur, die Flure=corridors
rumhocken=squat around
von der Hand in den Mund leben=live from hand to mouth,vivere alla giornata
Brombeer=blackberry (more)
Blätterdickicht=Thicket of leaves,boschetto di foglie
Betonwehr=lavoro in cemento armato
Planierrädern=Ruote livellatrici
Vorschriften=regolamento
Gleise=tracks
Lore=truck,wagon
Daneben=next to that,besides
zuraunen=whisper
Aufbruch=departure,breakup

SEITE208
Schmorbraten=stufato,pot roast
brutzelten=frizzle,sfrigolare
vorgefallen=occurred
Zügen=drag,strain,move
einschenkte=pour out
anstossen=brindare
ohne Punkt und Komma=senza punto e virgola (???)
stillschweigende=tacit,silent
Übereinkunft=agreement
ranzig=rancid
umrührte (umrühren)=stirred
vermengt=mixed up
gehäutet (häuten)=skinned
eklig=disgusting
genuschelt=mumbled
mitbekommen=get,realize

SEITE210
übermannte=overwhelmed
Betriebe=business
umzingelte=surrounded
im Beisein=in presence
Käseerlös=cheese proceeds
abbezahlen=pay off
autark=self sufficient
Stallmiete=stall rental
tilgen=pay off
behelfen=help
eingespart=saved
als ich das Thema anschnitt=quando affrontai l'argomento

SEITE212
Normalsterblicher=Normal mortal
dabei hast du sie dir selbst eingebrockt=you got it on yourself (???)
reg dich ab (abregen)=calm down
Riesenschrecken=huge horror
mithelfen=help along
kurz angebunden (jmdm. gegenüber kurz angebunden sein)=to be short with so, bruscamente
versehen=provide
verblichenen=faded
verschlissenen=worn out
Bittgebete=supplications

SEITE214
streichle=caress
erlegen=kill,shoot
beigebracht=taught
jemals=ever
einprägen=imprint,impress
vorgehabt=plan,intend

SEITE216
Elternteil=parent
zugedröhten=affollato
verwahrlosten=neglected
mitansehen=watch
aushändigte (aushändigen)=handed over

SEITE218
sich gefügt (fügen)=comply
die Zeit totschlagen=to kill time
vorhabe=plan
hinsoll=should go
raufziehen=pull up
verzerrt=distorted
hereinbrechend=breaking in

SEITE220
mir fiel auf=I noticed
versengt=scorched
ockergelb=ocher yellow
sandfarben=sand colored
loderte=blazed
Bretterbrücke=Wooden bridge
Rutsche=slide
umfing (umfangen)=surround
Grasbüschel=tuft of grass
Feldstecher=binoculars
Eindringling=intruder
auf die Lauer=on the lookout

SEITE222
zerknüllte=crumpled up,crushed
Schachtel=packet
verriegelt=locked
aufgestapelt=pile up
umgedreht=turned around
vergilbten=yellowed
brünstigen=on heat,rutting
sauer=angry
Ausschau hielten=looked out
angeworfen=started
Kreischen=screeching
Sägeblatt=saw blade
umrunden=circumnavigate
Krachen=crash,smash
was soll ich gross sagen=What should I say
getrauert=mourned

SEITE224
schleifen=drag
entgleisen=derail
verfing (verfangen)=entangle,caught
absoff (absaufen)=to flood
zerlegte (zerlegen) = disassemble
spalten=split
Fäustel und Spaltkeil=sledge hammer and splitting wedge (mazza e cuneo)
zaghaft=timid
Knacken=crack
dumpf=dull
ablöste=replace
durchschimmern=shine through
einzuritzen=scratch
trug (tragen)=carry

SEITE226
in der Glut gegart (garen)=cooked in the embers
gar=cooked
beizustehen=assist
abwimmeln=turn away
eine geschlagene Stunde=a full hour
erstbeste=the first that comes along
hab es mir angeschaut=I looked at it
ausgespart=left out
aus heiterem Himmel=out of the blue
Dämmerung=dusk
gefühlt=feel
einer allein kommt irgendwie durch=somehow one gets through alone
sich schlau genug anstellt=acts smart enough
ergründen=discover
