Abweichungen=deviation
Anforderungen=requirements
Anpassungs=adaptation
Auftrag,Aufträge=contract,order
Ausrichtung=alignment
Auswirkungen=impact
Begrüssung=welcome
Behebung=recovery
Benachrichtigung=notification
Beschluss=decision
Betreuung=mentoring
Bonität=creditworthiness
Durchlaufzeit=turnaround time
Eckdaten=fundamentals,key data
Einhaltung der Zielvorgaben=Attainment of the targets, compliance
Erfassung=recording, logging
Erfolgsfaktoren=success factor
Ergebnis=results, earnings
Existenzberechtigung=existence
Festlegen=set
Gegebenheiten=circumstances
Geltungsbereich=scope
Geschäftsanwender=business user
Anwender=user
Geschäftseinbruch=decline in business
Grundlagen=rudiments
Im Betracht ziehen=take into consideration
Kostenstellen=cost center
Kundenanfragen=customer inquiries
Kundenaufträgen=customer orderst
Kundenbedürfnisse=customer needs
Langfristigkeit=long term
Markteinschätzung=market assessment
Marktnachfrage=market demand
Massnahmen=measures
Massnahmenplan=action plan
Mehrwertgenerierung=surplus generation
Messgrössen=metrics
Mitbewerbs=competitor
Nachbearbeitungen=rework, cleanup
Offertanfragen=requests for proposal
Pendenzen=pending issues
Sitzung=meeting
Umsatz=revenue
Umsetzung=implementation
Umstände=circumstances
Verhältnisse=conditions
Verkauf=sale
Verletzung=violation
Vernachlässigung=neglect
Verschlüsselter=encrypted
Verzettelung=fragmentation
Verzögerte=delayed
Vorgaben=targets, specifications
Vorgehen=action
Werbung=advertising
Wettbewerbsfähigkeit=Wettbewerbsfähigkeit
Zielerreichung=achievement
Zielrichtung=objective
Zielsetzung=objective
Zielvorgaben=targets
Zuständigkeiten=responsibilities
abgebrochene=canceled
abgelehnte=rejected
bereitstellt=provides
besprechung=meeting, discussion
bestimmung=determination
eingegangene=incoming
erfolgt=takes place
erforderlich=required
erheblichen=significant
erledigten=completed
freigabe=release
mitteilung=notification
nachhaltig=sustainable
schwerwiegend=serious
umsatzzahlen=sales figures
unzureichendem=insufficient
veralteten=obsolete
verarbeiteter=processed
vorzubeugen=prevent
Überwachen=monitoring
überarbeiten=revise
Verzögerte=delayed
Steuerung=control
Pflege=maintenance
Lebenszyklus=lifecycle
Wiederherstellung=recovery
Ergreifen=adopt
Unterbrechung=interruption
Ausfall=failure
wiederauftretende=recurring
Einstufen=classify
Aufträgen=orders
verpassen=miss
antragsteller=applicant
Ausmass=magnitude
ungenügende=inadequate
Beurteilung=assessment
Aufnahme=recording
Leistungen=services
Kundenbefragung=customer survey
Problembehebungen=fixes
bei Bedarf=on demand, if required
vor ort=on the spot
Lieferung=Delivery
Verrechenbar=billable
abwicklung=conclusion
Lieferanten=suppliers
beschaffung=procurement
jahresabschluss=Financial statements

Kündigung=termination



Vertraulichkeit=Confidentiality
unberechtigten=unauthorized
Risikoeinschätzung=risk assessment
Rechenzentrum=data center
Genehmigung=approval


