

______________ ARTE


abgesehen=apart
unübersehbar=incalculable
langfristig =long term
Lieferung frei Bordsteinkante=Delivery free curbside
abgeholt=picked up
ermüdung=fatigue
aus heiterem (clear) Himmel=out of the blue
eignet sich hervorragend=is great
vormachen=demonstrate
wiederbelebung=reanimation
betrachter=observer
frühchen=premature child
abdrehen=turn
nachhelfen=help out
Punktion=injection
herbeigeeilt=hastened
herzversagen=heart failure
umgehen=workaround
ich gerne viel von mir preisgeben=I like to reveal a lot about myself
Beziehungsaufbau=relationship building

Beschwerden=complaints
Völlegefühl=bloating
verschluckt=swallowed

Sodbrennen=heartburn

irgendwer=anyone
alle Achtung=full respect
in digitalen Zeitalter=in the digital age
Medikamenten verabreichen=administer

Der passt sich den Gegebenheiten an=it adapts to the circumstances
Unbefugten=unauthorized, trespasser
ähnlich dem Verfahren=like the process
weitestgehend=largely
auseinanderhalten=keep apart


Schleichend=creeping
loswerden=get rid of
Zahnschmelz=tooth enamel
Geld verschwenden=waste money
Geld ausgeben=spend money


auf ihre Bedürfnisse einzugehen=to respond to their needs

bedürfnisbefriedigung=need satisfaction
fehlanzeige=dead loss, nil, none

nach belieben=at will

höchstgenau=with high precision

Zustand=state
angesiedelt=settled
karg=barren
gestaltet=designed
Unikate=unique
wegrand=wayside
ähneln=be similar to
Gehöfte=Homesteads
verrichten=perform
sticken, häkeln, flechten=embroider, crochet, braid
Scheu=shy
Gehörn=horned
Bräuche=custome
gesellige=sociable
vorlage=template
filzen=felt
gehaltvoll=nutritious
obhut=custody
überliefert=traditional
vorübergehend=temporarily
verweilen=dwell
vogelkunde=ornithology
umhergezogen=went about
verzehren=consume
Grunz=oink,grunt
Euter=udder (mammella)
unabdinglich=indispensable
Grasland=prairie
Hirten=shepherd
erlegt=killed,shot
Geistesrichtungen=schools of thought
auffordert=asks,request
Zusammenhänge=relationships
umgestülpt=inverted
nachwuchs=offsprings


https://www.arte.tv/de/videos/065301-001-A/traumrouten-des-orients/
Elefantenrüssel=trunk
erschließen=open up, develop
überragend=outstanding
ausnahmezustand=state of emergency


Fahrtauglichkeit=driving ability
herabsetzen=reduce
Überholen=overtaking
Abbiegen=turn
abblendlicht=dimmed headlights
Scheinwerfer=headlights
ausweichen=avoid
lediglich=merely
Verzweigung=branching
Rechtsvortritt=right of way
Nebenstrasse=side street

Anhängers=trailer
Ankuppeln=connect
einspuren=einordnen=place
trübem=cloudy
verweigern=deny
Zufahrt=entrance
Haftung=adhesive force,grip

aufwendig=costly
Aufwand=effort, expenditure
Nachfrage=demand
geschmirgelt=sanded
griffig=firm
prunkvoll=magnificently
schuldigkeit=duty
körperertüchtigung=physical training
entrinnen=escape
spendabel=generous
befindlichkeit=mood
Stechschritt=goose step
verzichten=renounce
gemeinsamkeiten=similarities
verlustreiche=wasteful
wuselige=bustling
unumstritten=undisputed
Zuweilen=occasionally
mitleidenschaft gezogenen Städten=affected cities
unbeugsam=unbending
Gewinnspanne=margin


mutmaßliche=supposed
betörende=captivating
vermächtnis=legacy
ansehen=regard
ertüchtigung=exercise
Überlieferung=tradition
nachzugehen=pursue
belebt=busy, animated
verdrängen=replace,repress
fürsorgliche Betreuung=caring care
barmherzigkeit=compassion
verstreut=scattered
Teig=dough
knusprig=crispy
Errungenschaften=achievements
heiter=cheerful,bright
derweil=meantime
beleidigen=offend
Sachgeschenke=tangible Gifts
genascht=nibbled
ersehnte=awaited
erwerben=purchase
gedeiht=flourishes

