01

derzeit=currently
ausüben=exert, practice
Glas splitter
Geisteszustand=state of mind
Zustand=condition
Umgang=contact
Einwände=objection
Vertragen=tolerate
räumliche=spacial
in Einsatz=operation
Vorzüge=advantage
unschätzbar=invaluable
unbestreitbar=incontrovertible 
Vetternwirtschaft=nepotism
Vettern=cousin
aus der Buchhaltung feuern=firing from accounting
entlassen=dismiss
das Licht ausmachen=turn off the light
Einverständniserklärung=consent form
Einwilligungserklärung=letter of consent
sie steht nur nicht auf dich=she just does not care about you
verheimlichen=conceal
Pulsadern=puls vein
Ellenbogen=elbow
venenstauung=vein stasis
hebt sich=lifts
behebung=remediation, removal
anhalten=stop
weismachen=make believe
klarkommen mit=cope with
Abmachung=agreement
bestanden=pass
Einstellung=attitude
Vorgesetzter=supervisor
untergebene=subordinate
Unterstellte=subordinate
beschaffen=procure
entweichen=escape
einwegventil=disposable valve
streicheln=caress
Ausschlag=deflection
Vorhof=atrium
Eiter=pus
vorgeschichte=prehistory
absaugen=vacuum
Verabreichen=administer
blutbild=blood count
benehmen sie sich=behave yourself
vorliegend=present
übersehen=overlook
Hase=rabbit
Einschränkung=limitation
benachteiligt=disadvantaged
vermasseln=to goof,to botch
vorgespielt=audition
abstimmung=vote


02
Stockwerk=floor
Akte=file
durchalten=hold on, persevere
weitläufig=spacious
vollständig=entirely
dabei=there
am Sabbern=salivating, on the drool
fachgerecht=professional
Nasenscheidewand=nose septum
Nasenscheidewandverkrümmung
verkrümmung=curvature
Furz,Fürze,furzen=fart
Eingriff=operation
umwerfen=overthrow
hackbraten=meatloaf
falschliegen=to be wrong
vermeintlichen=supposed
belehren=teach
angeordnet=disposed
gelogen=lügen=lie
vorgestellt=imagine
erbrochenes=vomited
freilegen=uncover
zankenden=streitenden=squabbling
aufträge=assignments
trottel=fool
bedauerlicherweise=regrettably
anbieten=offer
betreuung=care, support
aufstechen=puncture
versprechen=promise
beurteilen=judge
angeboren=innate,congenital
abwimmeln=get rid of
beharrlich=persevering
sich übergeben=vomit
dünndarm=small intestine
den Kopf hinhalten lassen=let go of the head
Heuchlerin=hypocrite


03

leihen=lend,borrow
ausleihen=lend
ausgeliehen=borrowed
lehrer=teacher
vorsichtsmaßnahme=precaution
reibungslos=smooth
fahrgelegenheit=means of transport
unvollständig=incomplete
verschwendung=waste
verengt=narrows
gefässe=vessels
such dir zwei aus=pick two
Gabe=gift
Gesicht/Gesichter=face/faces
Geschichte/Geschichten=story/stories
steif=stiff
fest=hard
Gerinnsel=clot
anhalten=stop
spülen=rinse
Lappen=lobe
strohhalm=drinking straw
unversehrt=intact
Blankoscheck=blank check
gereicht (reichen)=pass,offer
Schwamm=sponge
Stab=rod

04

scheitert=fails
abgehakt=check off
hört auf damit (aufhören)=stop it
Gemüsefach=vegetable compartment
Fehlgeburten=miscarriages
schwangerschaft=pregnancy
Dienstpläne=duty rosters
durchsetzen=prevail
abbruch=abort,cancellation
eindämmen=contain
schamlippe=labium
kränkungen=injuries
einschätzung=assessment
meine einschätzung nach=the way I see it
entzündet=inflamed
Drüse=gland
beistand=assistance
Scheidenwand=vaginal wall
Ich lag falsch=I was wrong
Nabelschnur=umbilical cord
sämtliche=all
Nähte=stitches
beistand=assistance
fassen=understand
unterleib=abdomen
ausgerissen=run away
gemeinnützige=charitable
kokosnuss=coconut
durchmacht=going through
es kommt nicht mehr vor=It will not happen again
ausstieg verpasst=missed the exit
an ihre stelle=in your place
widerlich=ekelhaft=disgusting
wasserhahn=water tap
Abwasch=washing 
Leck=leak
hinterfragt=question
andermal=some other time
aufziehen=verspotten=tease
anfassen=touch
sie hätte nicht anfassen dürfen=you should not have touched it
Spüle=kitchen sink
ausschlagen=knock out
dehnen=stretch
Schenkel=thigh
reizen=stimulate
hübsch=pretty
anfühlt=feels


05

rangehst, rangehen=answer (to the phone)
eklig=disgusting
herrühren=result from, be due to
tollpatschig=clumsy
verblüffend=perplexing
unheimlich=creepy
rausgeschmissen=kicked out, in a fix
zurechtkommen=cope
ausschlag=rash
Lenden=lumbar
vornehmen=make, carry out
zerrung=strain
zange=tongs
Brusthöhle=thoracic cavity
Eindringling=intruder
Fluchen=curse
trübe=cloudy


06

Leder=leather
prellungen=bruises
Ruß=soot
Schlinge=loop,noose
Brustbein=sternum
kühne=bold
zögerten=hesitated
Nebenanschluss=shunt
gelegt=placed
Oberschenkel=thigh
Unterschenkel=lower leg
Bräutigam=groom (fiancé)
gewöhnen=accustom
Schienen=rails
gerinnung=clotting
Schmeichelei=flattery
Ausweg=way out
Verschluss des Stumpfes=closure of the stump
einstweilige=provisional
unterbinden=prevent,stop
eingereicht=submitted
entzugsklinik=withdrawal clinic
Süchtig=addicted
betrogen=cheated
Wundausschneidung=debridement
aufgeregt=excited
verknüpfen=connect,link
eingeschätzt=evaluated,estimated


07

abgesturzt=crashed
anteilnahme=sympathy
vernarbte=scarred
Gehalt=salary
Kumpel=pal 
notaufnahme=emergency department
lastenaufzug=goods lift
absichtlich=intentionally
knistern=crackle
abhauen=bugger off
erhebliche=substantial
verschleppung=spreading
versagt=failed
umfang=scope
Knöchel=ankle
kindermädchen=nannies
Haushälter=housekeeper
ich verlaufe mich=I am lost
Verlegung=relocation

08
Ohrenstöpsel=ear plugs
Zwerchfell=Diafragma
beatmen=ventilate
Verlangt=desires
aufgeregt=excited
verlangt=required
abservieren=to polish off


09
knötchen=nodule
heiserkeit=hoarseness
kehlkopf=larynx
angenommen=assumed
angefordert=requested
aufgegeben=give up

10
Sackgasse=cul de sac
Vorschlag=proposition,suggestion
vertraulich=confidential
ratschläge=advice
arschkriecherei=ass licking
verdrängung=repression
unangemessen=inadequate
aufmüpfig=rebellious
aufsässig=defiant
schmarotzer=parasite
hochachtung=esteem
stur=stubborn

11
vorwitzig=inquisitive
abstossung=rejection
ablenken=distract
siehe mich an=look at me
überzeugen=convince
Kater=hangover
Schallwelle=sound wave
anfängt=begins
aufhört=ends

12
umwerfend=fantastic
ich werde die kündigung einreichen=I will file the cancellation
Ich breche ab=I cancel
genesung=recovery
deshalb=that's why
gemaßregelt=reprimanded
vergleich=comparison
haben sie den Stecker gezogen=they pulled the plug

13
unterlassen=refrain from
fassen sie mich nicht an=don't touch me
Veranlagung=predisposition
stimmbänder=vocal cords
Anastomosis=Anastomosis
Heuchlerei=hypocrisy
Engstirnigkeit=bigotry
urteilsvermögen=discernment
verreist=out of town
abgesehen davon=apart from this
Meerjungfrau=mermaid
Spülung=flush
Hoden=testicle
Anstand=decency

14
treiben=float


